# random seed 8152203959950210837
# players 2
# area 12814
# cell width: 1.08262964308
# cell size: 7
# openness: 0.31641748208
# grid size: (1, 2)
# tile size: (114, 55) 0.482456140351
# map size: (114, 110) 0.964912280702
# horz shear step: 1
# horz_shear
# maze type recursive backtracker
# final openness 0.31641748208
# map_type cell_maze
# random_seed 8152203959950210837
players 2
rows 110
cols 114
m ........%............%%%.......%%...%%%%%%%%%%..........%........................................%..........%%%%..
m .......%...............%%.......%%.%%......%%...........%........................................%%............%%%
m %%.....%................%.......%%%%....................%...................%%...................................%
m .%.....%................%.......%%%.....................%.....................%...................................
m .%%....%....%%%%..............%%........................%......................%.........%........................
m ........%%%%....%............%.........................%........................%.......%%..............%%%%......
m .................%..........................%%........%%.........................%.......%..........%%%%%.........
m .................%%%%................%.....%%........%%.............................................%%............
m .....................................%.....%.........%...........%..................................%.............
m ...........................................%%....................%%................................%%..........%%.
m ............................................%.....................%%%%%%.......................................%..
m ........%...................................%....................%%.......................%%......................
m ......%%%...................................%........%%........%%%.............................%..................
m .....%%......%%%...........%%......%........%%........%.....%%%%%%..............%.................................
m .....%......%.............%%.......%.........%.........%%%%%%....%...........%%%..................................
m .....%....................%.........%........%%........%%%.......%..........%............................%%%%%....
m ....%%...................%%..........%........%..................%....................%......................%....
m ....%................%%%%%...........%%.......%...................%...................%%.....................%....
m ....%...........................B....%%.......%%..................%...................%%%.....................%...
m ....%...............................%..........%..................%.....................%%........%...........%...
m .....%.............................%...........%........%........%%.......%..............%%.....%%%...........%...
m ......%....................%......%............%%......%........%%........%................%%%%%%..%..........%...
m .......%%%%%%..............%.....%.............%%%%%%.%........%%..........%................%......%..........%...
m .............%%...........%%.....%...........%%.....%%.....................%.......%........%.......%........%%%..
m ..............%%%%........%......%.........%%..............................%%......%........%...............%%%%%.
m ..........................%.......%.......%%.............................%%%...............%...............%....%%
m %........................%%.......%.......%.............................%%.................%...............%.....%
m %%.......................%........%%............................%.....%%%.................%%...............%......
m .%%%....................%%.........%%%%..............................%%................%%%........%.......%%......
m ..%%%...................%%............................%..............%...............%%%.......%%%%.......%.......
m .........................%.............................%.......................................%..........%.......
m .........................%%....................%........%...%%............................................%.......
m ...........................%%%.................%.........%%%%............................................%%.......
m ...........%%%..............%%...............................................%%.........................%%........
m ..........%%.%%%......................................................%.........................................%%
m ................%%....................................................%..................%.......................%
m .......................................%%.....%.........%............%.......................%%..................%
m ..................................%......%.............%%...........%%...........................................%
m %....................................................%%..%.........%%...........%.....................%%.........%
m .......%...........................................%%.....%.......%..............%%...............................
m .....%%...........................................%%.......%......%................%%............%................
m .........................%%.................................%......................%%............%................
m ...................%.......................................................%.......%%...........%.................
m ...................%...............................................................%............%..........%%.....
m ..................%%.............%......%%.........................................%...........%...........%......
m ...............%%%%.............%%.......%%.......................................%%.......%%%%%..........%%......
m .............%%.................%.........%%.%.....................%..............%............%%........%%.......
m ...............................%%..........%%%%..................%%%......%.......%.............%........%........
m ...............................%..........%%..%%.......%%%%%...%%%.......%%......%%.....................%%........
m ..............................%%..........%....%%..........%%%%%.........%........%....................%%.........
m ..%..........................%%..........%%.....%%............%..........%.........%%%.................%..........
m ..%%%%%%.....................%...........%.......%%%.....................%...........%%%...............%..........
m .%.....%%%............%.................%%........%%....................%..............%...............%%.........
m %%........%............................%%.........%%.....................%%............%%..............%%.........
m %.........%%............................%.........%%%............%.......%%%%%..........%.....%%.......%.........%
m ........................................%..........%%%%..........%............%%%.......%%...%%%%%%%%%%..........%
m ........................................%%............%%%.......%...............%%.......%%.%%......%%...........%
m ...................%%...................................%%%.....%................%.......%%%%....................%
m .....................%....................................%.....%................%.......%%%.....................%
m ......................%.........%.........................%%....%....%%%%..............%%........................%
m .......................%.......%%..............%%%%..............%%%%....%............%.........................%.
m ........................%.......%..........%%%%%..........................%..........................%%........%%.
m ...........................................%%.............................%%%%................%.....%%........%%..
m ........%..................................%..................................................%.....%.........%...
m ........%%................................%%..........%%............................................%%............
m .........%%%%%%.......................................%..............................................%............
m ........%%.......................%%..............................%...................................%............
m ......%%%.............................%........................%%%...................................%........%%..
m ...%%%%%%..............%......................................%%......%%%...........%%......%........%%........%..
m %%%%....%...........%%%.......................................%......%.............%%.......%.........%.........%%
m %.......%..........%............................%%%%%.........%....................%.........%........%%........%%
m ........%....................%......................%........%%...................%%..........%........%..........
m .........%...................%%.....................%........%................%%%%%...........%%.......%..........
m .........%...................%%%.....................%.......%...........................A....%%.......%%.........
m .........%.....................%%........%...........%.......%...............................%..........%.........
m ........%%.......%..............%%.....%%%...........%........%.............................%...........%........%
m .......%%........%................%%%%%%..%..........%.........%....................%......%............%%......%.
m ......%%..........%................%......%..........%..........%%%%%%..............%.....%.............%%%%%%.%..
m ..................%.......%........%.......%........%%%...............%%...........%%.....%...........%%.....%%...
m ..................%%......%........%...............%%%%%...............%%%%........%......%.........%%............
m ................%%%...............%...............%....%%..........................%.......%.......%%.............
m ...............%%.................%...............%.....%%........................%%.......%.......%..............
m .......%.....%%%.................%%...............%......%%.......................%........%%.....................
m ............%%................%%%........%.......%%.......%%%....................%%.........%%%%..................
m ............%...............%%%.......%%%%.......%.........%%%...................%%............................%..
m ......................................%..........%................................%.............................%.
m ...%%............................................%................................%%....................%........%
m %%%%............................................%%..................................%%%.................%.........
m ....................%%.........................%%...................%%%..............%%...........................
m .............%.........................................%%..........%%.%%%.........................................
m .............%..................%.......................%................%%.......................................
m ............%.......................%%..................%.......................................%%.....%.........%
m ...........%%...........................................%..................................%......%.............%%
m %.........%%...........%.....................%%.........%%....................................................%%..
m .%.......%..............%%......................................%...........................................%%....
m ..%......%................%%............%.....................%%...........................................%%.....
m ...%......................%%............%.........................................%%..............................
m ..................%.......%%...........%....................................%.....................................
m ..........................%............%..........%%........................%.....................................
m ..........................%...........%...........%........................%%.............%......%%...............
m .........................%%.......%%%%%..........%%.....................%%%%.............%%.......%%..............
m ..........%..............%............%%........%%....................%%.................%.........%%.%...........
m ........%%%......%.......%.............%........%.......................................%%..........%%%%..........
m %%%...%%%.......%%......%%.....................%%.......................................%..........%%..%%.......%%
m ..%%%%%.........%........%....................%%.......................................%%..........%....%%........
m .....%..........%.........%%%.................%............%..........................%%..........%%.....%%.......
m ................%...........%%%...............%............%%%%%%.....................%...........%.......%%%.....
m ...............%..............%...............%%..........%.....%%%............%.................%%........%%.....
m ................%%............%%..............%%.........%%........%............................%%.........%%.....
m ........%.......%%%%%..........%.....%%.......%.........%%.........%%............................%.........%%%....
